11111111111111111111111111111111111
1P1E000001C0000000000000000000000C1
10100000111111000000000001111111001
100000000000000G0000R000000001C1C01
10100011110010100111111100100101011
10100000C1001C1001C0000000100001001
10111111110011100111111111100001111
100000000000000000000000000000000C1
10010010001111111111111100011110001
1001CC100000000C1C0000000001CC10001
10011110001111111111111100010010001
1C00000000000000B0000000000000000C1
11111111111111111111111111111111111