1111111
1P00001
100EC01
1000001
1111111